8
7
SOXXXXXX
XOXXOXXX
XOOOOOOX
XOXOXXOX
XOXOXXOX
XXXOXXOX
XXXOOXOE